0000000000
0000000000
0000000000
0022200100
0000000000
0000000000
0000000220
0000000220
0000000000
2222222222